
:poss :n1 is :prep :n2	:poss :n1 zài :n2 :prep	XXX
There is :n1 :prep :n2	:n2 :prep yǒu :n1 		XXX
:poss :n is :iprep  		:poss :n zài :iprep		XXX
Excuse me, where is the :n ?	qǐngwèn, :n zài nǎr?		XXX
There are :num :n :iprep .	:iprep yǒu :num jiān :n .	XXX
The :n1 is :prep the :n2 .	:n1 zài :n2 :prep		XXX
The :room1 is :prep the :room2 .	:room1 zài :room2 :prep		XXX
When is :poss birthday?		:poss shēngrì shì shénme shíhòu?	XXX
:tm is :poss birthday.		:tm shì :poss shēngrì.		:tm 是 :poss 生日。
Whose birthday was :tm ?	:tm shì shéide shēngrì?		:tm 是谁的生日？
What day is :tm ?	:tm xīngqī jǐ?	:tm 星期几？
next :dow is :poss birthday.	xiàge :dow shì :poss shēngrì.	下个 :dow 是 :poss  生日。
9/29/2017	èr líng yī qī nián jiǔyuè èrshíjiǔrì	二0一七年九月二十九日
What's today's date?	jīntiān jǐyuèjǐhào?	今天几月几号？
Happy Birthday to You!		zhù nǐ shēngrì kuàilè!	祝你生日快乐！
Which year were you born?	nǐ shì nǎnián shēngde?	你是哪年生的？
go to sleep			shuìjiào		睡觉
school's over			fàngxué			放学
Is :pn :n in the :room ?	:pn :n zài chēkù ma?	:pn :n 在 :room 吗?

What time is it？	xiànzài jǐdiǎn？	现在几点？
good night		wǎnshàng hǎo		晚上好
Did :pn eat :meal ?	:pn yǒuméiyǒu chī :meal ?	:pn 有没有吃 :meal ？
When do :pn eat :meal ?	:pn shénme shíhòu chī :meal ?	:pn 什么时候吃 :meal ？
What are :pn doing?	:pn zài zuò shénme?	:pn 在做什么？
Can :pn :v ?		:pn huìbúhuì :v ?	:pn 会不会 :v ？
When do :pn :v ?	:pn jǐdiǎn :v ?	:pn 几点 :v ？
Do :pn like to :v ?	:pn xǐbùxǐhuān :v ?	:pn 喜不喜欢 :v ？
:pn :v at :time every morning.	:pn tiāntiān :tod :time :pv .	:pn 天天 :tod :time :v 。
Do :pn know how to :v ?	:pn huìbúhuì :v ?	:pn 会不会 :v ？
It's :time now!		xiànzài :time le!	现在 :time 了！
Do we have school next :dow ?	wǒmen xià :dow shàng bú shàngxué?	我们下 :dow 上不上学？


I didn't eat breakfast this morning.	wǒ jīntiān zǎoshàng méiyǒu chī zǎofàn.	我今天早上没有吃早饭。
What are you reading?	Nǐ zài kàn shénme shū?	你在看什么书？
I would like to have Chinese food tonight.	Wǒ jīntiānwǎnshàng xiǎng chī Zhōngguócài.	我今天晚上想吃中国菜。
When did you go to bed last night?	Nǐ zuótiān wǎnshàng jǐdiǎn shuìjiào?	你昨天晚上几点睡觉？
Did you do your Chinese homework?	Nǐ yǒuméiyǒu zuò Zhōngwén gōngkè?	你有没有做中文功课？
Our family eats dinner very late.	wǒmen jiā hěn wǎn chī wǎnfàn.	我们家很晚吃晚饭。




# Your cell phone is in front of the computer.	nǐde shǒujī zài diànnǎo qiánmiàn.	你的手机在电脑前面。
# There are ice creams in the refrigerator.	diànbīngxiāng lǐmiàn yǒu bīngqílín.	电冰箱里面有冰淇淋。

# My house has multi-stories	wǒjiā shì lóufáng	我家是楼房
# There are 4 bedrooms & 3 baths.	yǒu sì jiān wòshì hé sān jiān yùshì.	有四间卧室和三间浴室。
# My dog loves to sleep on the sofa.	wǒde gǒu xǐhuān zài shāfā shàngmiàn shuìjiào.	我的狗喜欢在沙发上面睡觉。
# Where do you watch TV?		nǐ zài nǎr kàndiànshì?	你在哪儿看电视？
# Behind our living room is the dining room.	wǒjiā de kètīng hòumiàn shì fàntīng.	我家的客厅后面是饭厅。
# Our washing machine is upstairs。	wǒmen de xǐyījī zài lóu shàng.	我们的洗衣机在楼上。
# Excuse me, where is the bathroom(toilet)?	qǐngwèn, cèsuǒ zài nǎr?	请问，厕所在哪儿？
# The dining room is facing the kitchen.	fàntīng zài chúfáng duìmiàn.	饭厅在厨房对面。
# I do my homework in my bedroom.	wǒ zài wǒde wòshì zuò gōngkè.	我在我的卧室做功课。
# There are 2 bathrooms downstairs.	lóuxià yǒu liǎngjiān yùshì.	楼下有两间浴室。



# look here		kàn zhèli	看这里
# open your book		bǎ shū dǎkāi	把书打开
# come to the front	dào qiánmiàn lái	到前面来
# return to your seat, please	qǐng huí zuòwèi	请回座位
# sit properly please	qǐng zuò hǎo	请坐好
# please raise your hand	qǐng jǔ shoǔ	请举手
# put down your hand	bǎ shǒu fàngxià	把手放下
# a little louder		dà shēng diǎnr	大声点儿
# say it again		zài shuō yí cì	再说一次
# very good		hěn hǎo	很好
# extremely good		fēicháng hǎo	非常好
# Are you busy?		Nǐ máng ma?	你忙吗？
# Where are you going?	Shàng nǎr qù?	上哪儿去？
# How is everything?	Zěnmeyàng?	怎么样？
# Have you eaten?		Chīfàn le ma?	吃饭了吗？
# Goodbye, teacher	lǎoshī zàijiàn.	老师再见
# Hello, fellow classmates.	tóngxuémen hǎo	同学们好
# I am Lanlan.		wǒ shì Lánlán.	我是兰兰。



